1111111111111111111111111111
100010000000000010000000C001
1P00100000C00000111100000001
100010C000000000000000000001
100010000100111110000C000001
100C100001000000100000000001
1000100001000000100000000001
1000100001111100000001111111
1000000001000000001111C00001
10000C00010000000000000000E1
1111111111111111111111111111
