1111111111111111111111111111111111111111111
100000P000000000000000000000000000000000001
1000C00000000000000000000000C000000000000C1
1000000000000000C00000000000000C00C00000001
1000000000000000000000000000000C00000000001
100000000000000000000000000000CC00000000001
1000000000000000000000000000000C00000000001
1000000000000000000000000000000C00000000001
1000000000000000000000000000000C00000000001
1000000000000000000000000001110C10000000001
1000000000000000000000000001000C10000000001
1111111111111111111111111110000C10000000001
1ECCCCCCCCCCCCCCCCCCCCCCCCCCCC0100000000001
1111111111111111111111111111111111111111111
