1111111111111111111111111111
10P0100000000C0010000000C001
1000100000000000111100000001
100010C00000000000000000D001
100110000100111110000C000001
1000100001000000100000000001
1000100001000C00100000000001
1000100001111100000001111111
1000000001000000001111C00001
100000000100000D000000000001
1000000001000000000000000001
1001110001000111111111111101
1000C0000100000000000000C001
1000000001000C0000000D000001
10000D0001000000000000000001
10000000010000000000000000E1
1111111111111111111111111111
