1111111111111111111111111111
1P1ECCCCCCCCCCCCCCCCCCCCCCC1
1110CCCCCCC00100001000000001
1010000001000000000000000001
1010010000000000001000000001
1000000000000100000000000001
1000100001000000100000000001
1000000000000000000000000001
1000100000000000100010000001
1000000000000000000000000001
1000001000100001000010000001
1000000000100001000000000001
1001000000000001000010000001
1000000100000000000000000001
1000D00000100010000010000001
1000000100010000001000000001
1000000000000000000000000001
1111111111111111111111111111
